ἆθλον, ἄθλου, τό	prize
ἀλλά (conj.)	but
ἀντί (prep.) + gen	instead of
ἀρετή, ἀρετῆς, ἡ	excellence, virtue
βουλή, βουλῆς, ἡ	will; council
γράφω, γράψω, ἔγραψα, γέγραφα, γέγραμμαι, ἐγράφην	write, draw
δή (postpositive article) 	in fact, of course
δῆμος, δήμου, ὁ	the people
δημοκρατία, δημοκρατίας, ἡ	democracy
διά (prep.) + gen. 	through
διά (prep.) + acc. 	on account of
εἰρήνη, εἰρήνης, ἡ	peace
ἐκκλησία, ἐκκλησίας, ἡ	assembly
ἐπεί (conj.)	after, when, since
ἐπειδή (conj.)	after, when, since
θύω, θύσω, ἔθυσα, τέθυκα, τέθυμαι, ἐτυθην sacrifice (verb.)
θυσία, θυσίας, ἡ sacrifice
ἱνα (conj.)	in order that
μή (adv.)	not
νίκη, νίκης, ἡ	victory
ὁπως (conj.)	in order that
ὀφθαλμός, ὀφθαλμοῦ, ὁ eye
παύω, παύσω, ἔπαυσα, πέπαυκα, πέπαυμαι, ἐπαύθην make stop, stop
περί (prep.) + gen. 	concering, about
περί (prep.) + dat. 	around
περί (prep.) + acc. 	around, concering
φυλάττω, φυλάξω, ἐφύλαξα, πεφύλαχα, πεφύλαγμαι, ἐφυλάχθην guard (verb)
ὠς (conj.) in order that
