ἄρχο, ἄρξω, ἦρξα, ἦρχα, ἦργμαι, ἤρχθην	to begin; to rule, be leader of
ἀπό + gen.	from, away from
αὐτός, -ή, -ό	-self; he, she, it; the same
βούλομαι, βουλήσομαι, —, —, βεβλούλημαι, ἐβούληθην	to wish, be willing, desire
γίγνομαι, γενήσομαι, ἐγένομην, γέγονα, γεγένημαι, —	to come to be, become, be born
εἰς (ἐς) + acc. 	into, to, in regard to
Ἕλλην, Ἕλληνος, ὁ	Greek
ἐπεί	when, after, since, because
ἔχω, ἔξω, ἔσχον, ἔσχηκα, -ἔσχημαι, —	have, possess; be able; be disposed
Κῦρος	Cyrus
λαμβάνω, λήψομαι, ἔλαβον, εἴληφα, εἴλημμαι, ἐλήφθην	to take, receive, catch, grasp
ὁπλίτης, -ου, ὁ	hopolite, armed soldier
ὅς, ἥ, ὅ	who, which, that
ὅσος, -η, -ον	as many as; all who, all which
οὖν	and so, then; at all events
παῖς, παιδός, ὁ, ἡ	child, boy, girl; slave
πάρ-ειμι	to be near, be present, be at hand
πᾶς, πᾶσα, πᾶν	every, all, the whole
πεδίον, τό	plain
ποιέω, ποιήσω, ἐποίησα, πεποίηκα, πεποίημαι, ἐποιήθην	to do, make, create, compose
στρατηγός, ὁ	general
Τισσαφέρνης, ὁ	Tissaphernes
τυγχάνω, τεύξομαι, ἔτυχον, τετύχημα, —, —	chance upon, get; meet; happen
φίλος, -α, -ον	friendly, dear; friend, kin
